{
  "content" :[
    ["W","W","W","W","W","W","W","W","W","W"],
    ["W","W","E","E","E","W","W","W","W","W"],
    ["W","E","E","E","E","W","W","W","W","W"],
    ["W","E","E","W","G","W","E","E","E","W"],
    ["W","S","E","W","G","W","E","B","E","W"],
    ["W","E","E","W","G","W","E","E","W","W"],
    ["W","E","E","E","E","W","E","E","W","W"],
    ["W","W","E","E","W","W","B","B","W","W"],
    ["W","W","W","E","E","E","E","E","W","W"],
    ["W","W","W","E","E","W","W","W","W","W"],
    ["W","W","W","W","W","W","W","W","W","W"]
  ],
  "bestSolution" : 181,
  "minPushes" : 56
}