{
  "content" :[
    ["W","W","W","W","W","W","W","W","W","W"],
    ["W","E","E","W","W","W","W","W","W","W"],
    ["W","E","E","G","E","W","W","E","G","W"],
    ["W","E","B","W","E","E","E","E","G","W"],
    ["W","W","E","W","W","E","W","E","G","W"],
    ["W","W","E","E","E","E","W","E","E","W"],
    ["W","W","W","W","W","E","W","E","E","W"],
    ["W","W","W","E","S","B","E","W","W","W"],
    ["W","W","W","E","B","B","E","W","W","W"],
    ["W","W","W","E","E","E","E","W","W","W"],
    ["W","W","W","W","W","W","W","W","W","W"]
  ],
  "bestSolution" : 131,
  "minPushes" : 38
}