{
  "content" :[
    ["W","W","W","W","W","W","W","W","W","W"],
    ["W","W","E","G","G","G","G","W","W","W"],
    ["W","E","E","E","W","W","W","W","W","W"],
    ["W","E","E","E","B","E","B","E","S","W"],
    ["W","W","W","E","E","B","E","B","E","W"],
    ["W","W","W","W","W","E","E","E","E","W"],
    ["W","W","W","W","W","W","W","W","W","W"]
  ],
  "bestSolution" : 94,
  "minPushes" : 34
}