{
  "content" : [
    ["W","W","W","W","W","W","W","W","W"],
    ["W","E","E","E","W","W","W","W","W"],
    ["W","E","B","E","E","W","W","W","W"],
    ["W","W","E","B","E","W","W","W","W"],
    ["W","W","W","W","S","G","E","E","W"],
    ["W","W","W","E","E","G","W","E","W"],
    ["W","W","W","E","E","E","E","E","W"],
    ["W","W","W","W","W","W","W","W","W"]
  ],
  "bestSolution" : 49,
  "minPushes" : 11
}