{
  "content" : [
    ["W","W","W","W","W","W","W","W"],
    ["W","W","W","E","E","E","W","W"],
    ["W","E","B","E","W","E","W","W"],
    ["W","E","W","E","E","G","E","W"],
    ["W","E","E","E","E","W","E","W"],
    ["W","W","B","W","G","E","E","W"],
    ["W","W","S","E","E","W","W","W"],
    ["W","W","W","W","W","W","W","W"]
  ],
  "bestSolution" : 60,
  "minPushes" : 10
}