{
  "content" : [
    ["W","W","W","W","W","W","W"],
    ["W","G","E","W","W","W","W"],
    ["W","G","S","E","W","W","W"],
    ["W","G","E","B","W","W","W"],
    ["W","W","B","E","W","W","W"],
    ["W","W","E","B","E","E","W"],
    ["W","W","E","E","E","E","W"],
    ["W","W","E","E","W","W","W"],
    ["W","W","W","W","W","W","W"]
  ],
  "bestSolution" : 52,
  "minPushes" : 21
}

