{
  "content" :[
    ["W","W","W","W","W","W","W","W"],
    ["W","W","E","E","E","W","W","W"],
    ["W","W","B","W","E","W","W","W"],
    ["W","E","E","E","B","S","E","W"],
    ["W","E","W","E","E","W","E","W"],
    ["W","E","W","G","E","G","E","W"],
    ["W","E","E","E","W","W","W","W"],
    ["W","W","W","W","W","W","W","W"]
  ],
  "bestSolution" : 85,
  "minPushes" : 13
}