{
  "content" :[
    ["W","W","W","W","W","W","W","W","W","W"],
    ["W","W","E","E","E","E","E","E","W","W"],
    ["W","W","S","E","E","E","B","E","W","W"],
    ["W","W","E","W","W","W","B","E","W","W"],
    ["W","E","G","G","G","G","G","W","W","W"],
    ["W","E","B","E","B","E","B","E","E","W"],
    ["W","W","W","W","W","W","E","W","E","W"],
    ["W","W","W","W","W","W","E","E","E","W"],
    ["W","W","W","W","W","W","W","W","W","W"]
  ],
  "bestSolution" : 205,
  "minPushes" : 50
}