{
  "content" : [
    ["W","W","W","W","W","W","W","W","W"],
    ["W","W","W","E","E","W","W","W","W"],
    ["W","E","E","E","E","E","B","E","W"],
    ["W","E","W","E","E","W","B","E","W"],
    ["W","E","G","E","G","W","S","E","W"],
    ["W","W","W","W","W","W","W","W","W"]
  ],
  "bestSolution" : 41,
  "minPushes" : 13
}

