{
  "content" :[
    ["W","W","W","W","W","W","W","W","W","W","W","W"],
    ["W","E","E","E","W","W","W","W","G","G","E","W"],
    ["W","E","B","B","B","E","E","E","E","E","E","W"],
    ["W","E","E","E","B","W","E","E","G","G","E","W"],
    ["W","W","W","E","S","W","E","E","W","W","E","W"],
    ["W","W","W","E","E","W","W","E","E","E","E","W"],
    ["W","W","W","W","W","W","W","W","W","W","W","W"]
  ],
  "bestSolution" : 104,
  "minPushes" : 36
}