[
  ["W","W","W","W","W","W","W","W"],
  ["W","W","E","E","E","W","W","W"],
  ["W","W","E","W","B","E","W","W"],
  ["W","E","B","E","E","E","E","W"],
  ["W","G","E","G","W","E","E","W"],
  ["W","W","W","E","S","E","W","W"],
  ["W","W","W","E","W","E","W","W"],
  ["W","W","W","E","E","E","W","W"],
  ["W","W","W","W","W","W","W","W"]
]