[
  ["W","W","W","W","W","W","W","W","W","W","W","W","W","W"],
  ["W","G","G","E","E","W","E","E","E","E","E","W","W","W"],
  ["W","G","G","E","E","W","E","B","E","E","B","E","E","W"],
  ["W","G","G","E","E","W","B","W","W","W","W","E","E","W"],
  ["W","G","G","E","E","E","E","S","E","W","W","E","E","W"],
  ["W","G","G","E","E","W","E","W","E","E","B","E","W","W"],
  ["W","W","W","W","W","W","E","W","W","B","E","B","E","W"],
  ["W","W","W","E","B","E","E","B","E","B","E","B","E","W"],
  ["W","W","W","E","E","E","E","W","E","E","E","E","E","W"],
  ["W","W","W","W","W","W","W","W","W","W","W","W","W","W"]
]