[
  ["W","W","W","W"],
  ["W","S","G","W"],
  ["W","B","E","W"],
  ["W","E","E","W"],
  ["W","E","B","W"],
  ["W","G","E","W"],
  ["W","E","E","W"],
  ["W","E","E","W"],
  ["W","W","W","W"]
]