[
  ["W","W","W","W","W","W","W","W"],
  ["W","W","E","E","E","E","E","W"],
  ["W","W","E","G","B","G","E","W"],
  ["W","W","E","B","S","B","E","W"],
  ["W","E","E","G","B","G","E","W"],
  ["W","E","E","E","E","E","E","W"],
  ["W","W","W","W","W","W","W","W"]
]