[
    ["W","W","W","W","W","W","W","W","W","W","W"],
    ["W","W","W","W","W","W","E","E","E","W","W"],
    ["W","W","W","W","W","W","E","E","E","E","W"],
    ["W","W","W","W","W","W","W","E","E","E","W"],
    ["W","W","E","E","E","E","E","W","G","E","W"],
    ["W","E","B","E","B","E","S","E","E","W","W"],
    ["W","E","W","W","W","W","W","W","G","W","W"],
    ["W","E","E","E","E","E","E","E","E","W","W"],
    ["W","W","W","W","W","W","W","W","W","W","W"]
]