[
  ["W","W","W","W","W","W","W","W","W","W","W","W","W","W","W","W","W","W","W"],
  ["W","W","W","W","W","E","E","E","W","W","W","W","W","W","W","W","W","W","W"],
  ["W","W","W","W","W","B","E","E","W","W","W","W","W","W","W","W","W","W","W"],
  ["W","W","W","W","W","E","E","B","W","W","W","W","W","W","W","W","W","W","W"],
  ["W","W","W","E","E","B","E","B","E","W","W","W","W","W","W","W","W","W","W"],
  ["W","W","W","E","W","E","W","W","E","W","W","W","W","W","W","W","W","W","W"],
  ["W","E","E","E","W","E","W","W","E","W","W","W","W","W","E","E","G","G","W"],
  ["W","E","B","E","E","B","E","E","E","E","E","E","E","E","E","E","G","G","W"],
  ["W","W","W","W","W","E","W","W","W","E","W","S","W","W","E","E","G","G","W"],
  ["W","W","W","W","W","E","E","E","E","E","W","W","W","W","W","W","W","W","W"],
  ["W","W","W","W","W","W","W","W","W","W","W","W","W","W","W","W","W","W","W"]
]