{
  "content" :[
    ["W","W","W","W","W","W","W","W","W","W","W","W","W","W","W"],
    ["W","E","E","W","W","W","W","W","W","W","E","E","E","W","W"],
    ["W","E","E","E","E","W","W","W","W","W","B","E","B","E","W"],
    ["W","G","G","W","E","W","W","W","W","W","E","W","E","E","W"],
    ["W","E","E","S","E","E","E","E","W","E","B","E","B","E","W"],
    ["W","G","G","W","E","E","E","E","E","E","E","E","E","W","W"],
    ["W","W","E","E","E","W","W","W","W","W","W","W","W","W","W"],
    ["W","W","W","W","W","W","W","W","W","W","W","W","W","W","W"]
  ],
  "bestSolution" : 246,
  "minPushes" : 68
}