{
  "content" :[
    ["W","W","W","W","W","W","W","W","W","W","W"],
    ["W","G","G","G","G","W","E","E","E","E","W"],
    ["W","E","E","W","E","E","E","B","B","E","W"],
    ["W","E","E","S","E","E","W","W","E","E","W"],
    ["W","E","E","E","E","E","W","W","B","E","W"],
    ["W","W","W","W","W","W","E","E","B","E","W"],
    ["W","W","W","W","W","W","E","E","E","E","W"],
    ["W","W","W","W","W","W","W","W","W","W","W"]
  ],
  "bestSolution" : 149,
  "minPushes" : 44
}