[
  ["W","W","W","W","W","W","W"],
  ["W","E","E","E","E","E","W"],
  ["W","E","G","B","G","E","W"],
  ["W","E","B","G","B","E","W"],
  ["W","E","G","B","G","E","W"],
  ["W","E","B","G","B","E","W"],
  ["W","E","E","S","E","E","W"],
  ["W","W","W","W","W","W","W"]
]